[
  {
    "type": "mapgen",
    "om_terrain": [ "dante_pocket_core" ],
    "object": {
      "fill_ter": "t_strconc_floor",
      "rows": [
        "########################",
        "#......................#",
        "#..RRRR....BBBB........#",
        "#..RRRR................#",
        "#......................#",
        "#....WWWWWWWWWWWWWW....#",
        "#....W............W....#",
        "#....W............W....#",
        "#....W............W....#",
        "#....W............W....#",
        "#....WWWWWWWWWWWWWW....#",
        "#......................#",
        "#.........X............#",
        "#......................#",
        "#......................#",
        "#......................#",
        "#..........RR..........#",
        "#..........RR..........#",
        "#......................#",
        "#......................#",
        "#......................#",
        "#......................#",
        "#......................#",
        "########################"
      ],
      "terrain": {
        "#": "t_wall_metal",
        ".": "t_strconc_floor",
        "W": "t_wall_metal"
      },
      "furniture": {
        "X": "f_dante_return_portal",
        "B": "f_metal_bench",
        "R": "f_rack"
      }
    }
  },
  {
    "type": "mapgen",
    "update_mapgen_id": "dante_workshop_update",
    "object": {
      "rows": [
        "########################",
        "#......................#",
        "#..RRRR....BBBB........#",
        "#..RRRR................#",
        "#......................#",
        "#....WWWWWWWWWWWWWW....#",
        "#....W............W....#",
        "#....W............W....#",
        "#....W............W....#",
        "#....W............W....#",
        "#....WWWWWWWWWWWWWW....#",
        "#......................#",
        "#.........X............#",
        "#......................#",
        "#......................#",
        "#......................#",
        "#..........RR..........#",
        "#..........RR..........#",
        "#......................#",
        "#......................#",
        "#......................#",
        "#......................#",
        "#......................#",
        "########################"
      ],
      "terrain": {
        "#": "t_wall_metal",
        ".": "t_strconc_floor",
        "W": "t_wall_metal",
        "R": "t_strconc_floor",
        "B": "t_strconc_floor",
        "X": "t_strconc_floor"
      },
      "furniture": {
        "X": "f_dante_return_portal",
        "B": "f_metal_bench",
        "R": "f_rack"
      }
    }
  },
  {
    "type": "mapgen",
    "om_terrain": [ "dante_void_floor" ],
    "object": {
      "fill_ter": "t_strconc_floor",
      "rows": [
        "........................",
        "........................",
        "........................",
        "........................",
        "........................",
        "........................",
        "........................",
        "........................",
        "........................",
        "........................",
        "........................",
        "........................",
        "........................",
        "........................",
        "........................",
        "........................",
        "........................",
        "........................",
        "........................",
        "........................",
        "........................",
        "........................",
        "........................",
        "........................"
      ],
      "terrain": { ".": "t_strconc_floor" }
    }
  }
]
